tileset1.png
16 16 75 38 1 162 216 255
73 32
 0  0  0  0  0  0     0     0  0  0  0  0     0     0  0  0  0  0  0  0  0  0  0  0  0  0  0  0  0  0  0  0     0  0  0  0  0  0  0  0  0  0  0  0  0  0  0  0  0  0  0  0  0  0  0  0  0  0  0  0  0  0  0  0  0  0  0  0  0  0  0  0  0
 0  0  0  0  0  0     0     0  0  0  0  0     0     0  0  0  0  0  0  0  0  0  0  0  0  0  0  0  0  0  0  0     0  0  0  0  0  0  0  0  0  0  0  0  0  0  0  0  0  0  0  0  0  0  0  0  0  0  0  0  0  0  0  0  0  0  0  0  0  0  0  0  0 
 0  0  0  0  0  0     0     0  0  0  0  0     0     0  0  0  0  0  0  0  0  0  0  0  0  0  0  0  0  0  0  0     0  0  0  0  0  0  0  0  0  0  0  0  0  0  0  0  0  0  0  0  0  0  0  0  0  0  0  0  0  0  0  0  0  0  0  0  0  0  0  0  0
 0  0  0  0  0  0     0     0  0  0  0  0     0     0  0  0  0  0  0  0  0  0  0  0  0  0  0  0  0  0  0  0     0  0  0  0  0  0  0  0  0  0  0  0  0  0  0  0  0  0  0  0  0  0  0  0  0  0  0  0  0  0  0  0  0  0  0  0  0  0  0  0  0
 0  0  0  0  0  0     0     0  0  0  0  0     0     0  0  0  0  0  0  0  0  0  0  0  0  0  0  0  0  0  0  0     0  0  0  0  0  0  0  0  0  0  0  0  0  0  0  0  0  0  0  0  0  0  0  0  0  0  0  0  0  0  0  0  0  0  0  0  0  0  0  0  0
 0  0  0  0  0  0     0     0  0  0  0  0     0     0  0  0  0  0  0  0  0  0  0  0  0  0  0  0  0  0  0  0     0  0  0  0  0  0  0  0  0  0  0  0  0  0  0  0  0  0  0  0  0  0  0  0  0  0  0  0  0  0  0  0  0  0  0  0  0  0  0  0  0 
 0  0  0  0  0  0     0     0  0  0  0  0     0     0  0  0  0  0  0  0  0  0  0  0  0  0  0  0  0  0  0  0     0  0  0  0  0  0  0  0  0  0  0  0  0  0  0  0  0  0  0  0  0  0  0  0  0  0  0  0  0  0  0  0  0  0  0  0  0  0  0  0  0
 0  0  0  0  0  0     0     0  0  0  0  0     0     0  0  0  0  0  0  0  0  0  0  0  0  0  0  0  0  0  0  0     0  0  0  0  0  0  0  0  0  0  0  0  0  0  0  0  0  0  0  0  0  0  0  0  0  0  0  0  0  0  0  0  0  0  0  0  0  0  0  0  0
 0  0  0  0  0  0     0     0  0  0  0  0     0     0  0  0  0  0  0  0  0  0  0  0  0  0  0  0  0  0  0  0     0  0  0  0  0  0  0  0  0  0  0  0  0  0  0  0  0  0  0  0  0  0  0  0  0  0  0  0  0  0  0  0  0  0  0  0  0  0  0  0  0
 0  0  0  0  0  0     0     0  0  0  0  0     0     0  0  0  0  0  0  0  0  0  0  0  0  0  0  0  0  0  0  0     0  0  0  0  0  0  0  0  0  0  0  0  0  0  0  0  0  0  0  0  0  0  0  0  0  0  0  0  0  0  0  0  0  0  0  0  0  0  0  0  0 
 0  0  0  0  0  0     0     0  0  0  0  0     0     0  0  0  0  0  0  0  0  0  0  0  0  0  0  0  0  0  0  0     0  0  0  0  0  0  0  0  0  0  0  0  0  0  0  0  0  0  0  0  0  0  0  0  0  0  0  0  0  0  0  0  0  0  0  0  0  0  0  0  0
 0  0  0  0  0  0     0     0  0  0  0  0     0     0  0  0  0  0  0  0  0  0  0  0  0  0  0  0  0  0  0  0     0  0  0  0  0  0  0  0  0  0  0  0  0  0  0  0  0  0  0  0  0  0  0  0  0  0  0  0  0  0  0  0  0  0  0  0  0  0  0  0  0
 0  0  0  0  0  0     0     0  0  0  0  0     0     0  0  0  0  0  0  0  0  0  0  0  0  0  0  0  0  0  0  0     0  0  0  0  0  0  0  0  0  0  0  0  0  0  0  0  0  0  0  0  0  0  0  0  0  0  0  0  0  0  0  0  0  0  0  0  0  0  0  0  0
 0  0  0  0  0  0     0     0  0  0  0  0  2482  2483  0  0  0  0  0  0  0  0  0  0  0  0  0  0  0  0  0  0     0  0  0  0  0  0  0  0  0  0  0  0  0  0  0  0  0  0  0  0  0  0  0  0  0  0  0  0  0  0  0  0  0  0  0  0  0  0  0  0  0
 0  0  0  0  0  0     0     0  0  0  0  0  2557  2558  0  0  0  0  0  0  0  0  0  0  0  0  0  0  0  0  0  0     0  0  0  0  0  0  0  0  0  0  0  0  0  0  0  0  0  0  0  0  0  0  0  0  0  0  0  0  0  0  0  0  0  0  0  0  0  0  0  0  0
 0  0  0  0  0  0     0     0  0  0  0  0     0     0  0  0  0  0  0  0  0  0  0  0  0  0  0  0  0  0  0  0     0  0  0  0  0  0  0  0  0  0  0  0  0  0  0  0  0  0  0  0  0  0  0  0  0  0  0  0  0  0  0  0  0  0  0  0  0  0  0  0  0
 0  0  0  0  0  0     0     0  0  0  0  0     0     0  0  0  0  0  0  0  0  0  0  0  0  0  0  0  0  0  0  0     0  0  0  0  0  0  0  0  0  0  0  0  0  0  0  0  0  0  0  0  0  0  0  0  0  0  0  0  0  0  0  0  0  0  0  0  0  0  0  0  0
 0  0  0  0  0  0     0     0  0  0  0  0     0     0  0  0  0  0  0  0  0  0  0  0  0  0  0  0  0  0  0  0     0  0  0  0  0  0  0  0  0  0  0  0  0  0  0  0  0  0  0  0  0  0  0  0  0  0  0  0  0  0  0  0  0  0  0  0  0  0  0  0  0 
 0  0  0  0  0  0     0     0  0  0  0  0     0     0  0  0  0  0  0  0  0  0  0  0  0  0  0  0  0  0  0  0     0  0  0  0  0  0  0  0  0  0  0  0  0  0  0  0  0  0  0  0  0  0  0  0  0  0  0  0  0  0  0  0  0  0  0  0  0  0  0  0  0
 0  0  0  0  0  0     0     0  0  0  0  0     0     0  0  0  0  0  0  0  0  0  0  0  0  0  0  0  0  0  0  0     0  0  0  0  0  0  0  0  0  0  0  0  0  0  0  0  0  0  0  0  0  0  0  0  0  0  0  0  0  0  0  0  0  0  0  0  0  0  0  0  0
 0  0  0  0  0  0     0     0  0  0  0  0     0     0  0  0  0  0  0  0  0  0  0  0  0  0  0  0  0  0  0  0     0  0  0  0  0  0  0  0  0  0  0  0  0  0  0  0  0  0  0  0  0  0  0  0  0  0  0  0  0  0  0  0  0  0  0  0  0  0  0  0  0
 0  0  0  0  0  0     0     0  0  0  0  0     0     0  0  0  0  0  0  0  0  0  0  0  0  0  0  0  0  0  0  0     0  0  0  0  0  0  0  0  0  0  0  0  0  0  0  0  0  0  0  0  0  0  0  0  0  0  0  0  0  0  0  0  0  0  0  0  0  0  0  0  0 
 0  0  0  0  0  0     0     0  0  0  0  0     0     0  0  0  0  0  0  0  0  0  0  0  0  0  0  0  0  0  0  0     0  0  0  0  0  0  0  0  0  0  0  0  0  0  0  0  0  0  0  0  0  0  0  0  0  0  0  0  0  0  0  0  0  0  0  0  0  0  0  0  0
 0  0  1  2  3  0     0     0  0  0  0  0     0     0  0  0  0  0  0  0  0  0  0  0  0  0  0  0  0  0  0  0     0  0  0  0  0  0  0  0  0  0  0  1  2  3  0  0  0  0  0  0  0  0  0  0  0  0  0  0  0  0  0  0  0  0  0  0  0  0  0  0  0
 0  0 76 77 78  0     0     0  0  0  0  0     0     0  0  0  0  0  0  0  0  0  0  0  0  0  0  0  0  0  0  0     0  0  0  0  0  0  0  0  0  0  0 76 77 78  0  0  0  0  0  0  0  0  0  0  0  0  0  0  0  0  0  0  0  0  0  0  0  0  0  0  0
 0  0 76 77 78  0     0     0  0  0  0  0     0     0  0  0  0  0  0  0  0  0  0  0  0  0  0  0  0  0  0  0  2490  0  0  0  0  0  0  0  0  0  0 76 77 78  0  0  0  0  0  0  0  0  0  0  0  0  0  0  0  0  0  0  0  0  0  0  0  0  0  0  0
 0  0 76 77 78  0     0     0  0  0  0  0     0     0  0  0  0  0  0  0  0  0  0  0  0  0  0  0  0  0  0  0  2565  0  0  0  0  0  0  0  0  0  0 76 77 78  0  0  0  0  0  0  0  0  0  0  0  0  0  0  0  0  0  0  0  0  0  0  0  0  0  0  0
 1  2  2  2  2  3  2488  2489  1  2  2  2     2     2  3  0  0  0  1  2  2  2  2  2  2  2  2  2  2  2  2  3  2565  1  2  2  2  2  2  3  0  1  2  2  2  2  3  0  0  1  2  2  2  2  2  3  0  0  0  1  2  2  2  2  2  2  2  2  2  2  2  2  3
76 77 77 77 77 78  2563  2564  76 77 77 77    77   77 78  0  0  0 76 77 77 77 77 77 77 77 77 77 77 77 77 78  2565 76 77 77 77 77 77 78  0 76 77 77 77 77 78  0  0 76 77 77 77 77 77 78  0  0  0 76 77 77 77 77 77 77 77 77 77 77 77 77 78
76 77 77 77 77 78  2563  2564  76 77 77 77    77   77 78  0  0  0 76 77 77 77 77 77 77 77 77 77 77 77 77 78  2565 76 77 77 77 77 77 78  0 76 77 77 77 77 78  0  0 76 77 77 77 77 77 78  0  0  0 76 77 77 77 77 77 77 77 77 77 77 77 77 78
76 77 77 77 77 78  2563  2564  76 77 77 77    77   77 78  0  0  0 76 77 77 77 77 77 77 77 77 77 77 77 77 78  2565 76 77 77 77 77 77 78  0 76 77 77 77 77 78  0  0 76 77 77 77 77 77 78  0  0  0 76 77 77 77 77 77 77 77 77 77 77 77 77 78
76 77 77 77 77 78  2563  2564  76 77 77 77    77   77 78  0  0  0 76 77 77 77 77 77 77 77 77 77 77 77 77 78  2565 76 77 77 77 77 77 78  0 76 77 77 77 77 78  0  0 76 77 77 77 77 77 78  0  0  0 76 77 77 77 77 77 77 77 77 77 77 77 77 78
